R 1920 1080
NO ./assets/textures/LavaF2.xpm
SO ./assets/textures/Bricks.xpm
WE ./assets/textures/Sand.xpm
EA ./assets/textures/WoolSnow.xpm
SKY ./assets/textures/clouds_blue.xpm

S ./assets/sprites/gun.xpm
H ./assets/sprites/cage3.xpm
T ./assets/sprites/dead.xpm
C 51,53,51
F 36,85,1

        1111111111111111111111111
        1000000000110000000000001
        1000000000110000000020001
        1011000001110001000000001
        1001000000000000000010001
111111111011000001110000000000001
100000000011000001110111111111111
11110111111111011100000010001
11110111111111011101010010001
11022000110101011100000000001
12034020000000000000200010001
10404000000000000000200010001
1034003000000E000000200010001
10400000000000000000200010001
10000000000000001100200010001
10000010000000001100200010001
10000000000000001100200010001
10002034020000001100200010001
10040400000010001100200010001
10003400300000001100200010001
10000000000000001100200010001
10000000000000001100200010001
10000010000000001100200010001
10000000000000001100200010001
10000000000000001100200010001
10000000030000001100200010001
10000000000000001100200010001
10000000000000001100200010001
10000000000000001100200010001
10000000000000001100200010001
10000000000000001100200010001
10000000000000001100200010001
10000000000000001100200010001
10000000000000001100200010001
10000000000000001100200010001
10000000000000001100200010001
10000000000000001100200010001
10000000000000001100200010001
10000000000000001100200010001
10000000000000001100200010001
10000000000000001100200010001
10000000000000001100200010001
10000000000000001100200010001
10000000000000001100200010001
10000000000000001100200010001
10000000000000001100200010001
10000000000000001100200010001
10000000000000001100200010001
10000000000000001100200010001
10000000000000001100200010001
10000000000000001100200010001
10000000000000001100200010001
10000000000000001100200010001
10000000000000001100200010001
10000000000000001100200010001
10000000000000001100200010001
10000000000000001100200010001
10000000000000001100200010001
10200201004000001100000010001
100300302000000011010100100011111
110000011101010111110111100000001
11110111 1110101 1 1111 100011121
11111111 1111111 111111111111 111
