R 1920 1080
NO ./assets/textures/LavaF2.xpm
SO ./assets/textures/Bricks.xpm
WE ./assets/textures/Sand.xpm
EA ./assets/textures/WoolSnow.xpm
SKY ./assets/textures/clouds_blue.xpm

S ./assets/sprites/pilar.xpm
H ./assets/sprites/companion.xpm
T ./assets/sprites/skulls.xpm
C 51,53,51
F 36,85,1

        1111111111111111111111111
        1000000000110000000000001
        1000000000110000000000001
        1002000001110002000020001
        1002000000000000000000001
111111111002000001110000000000001
130000000002000001110111111111111
11110111110111011100000010001
11110111111111011101010010001
11000000110101011100000000001
10000000000000000000000010001
12000000S00000000000000010001
13000000000000000000020010001
10000300000000000000000010001
10000000001111111100000010001
14000002000000001100020010001
10020000000000001100000010001
10000002044400001101001000001
10020000044400001100000010001
10000002044400001111111110001
10000000044400001130000010001
10000000044400001100000010111
10000000044400001100000010001
10000000044400001100000011101
10000000044400001100000000001
10000000044400001100011110001
10000000044400001100000310001
10000000044400001100200010001
11111110044400001100004000001
10000000044400001100200010001
10000000044400001100000010001
10000000044400001111111110001
10000000044400001100000010001
10002002000400001100400000001
10000000000000001100000011111
10002002000020001100000010001
100000000000000011010100000011111
110000011101010111110111100000001
11114111 1110131 1 1111 100011141
11111111 1111111 111111111111 111
